{
  "20": "A",
  "15": "A",
  "11": "A",
  "27": "A",
  "23": "A",
  "7": "A",
  "6": "A",
  "13": "A",
  "12": "A",
  "16": "A",
  "10": "A",
  "26": "A",
  "30": "A",
  "22": "A",
  "17": "A",
  "28": "B",
  "2": "B",
  "14": "B",
  "19": "B",
  "3": "B",
  "18": "B",
  "29": "B",
  "5": "B",
  "25": "B",
  "8": "B",
  "9": "B",
  "24": "B",
  "1": "B",
  "4": "B",
  "21": "B"
}